7 7 8 7 8 7 7 7 7 7 8 8 8 7 7 7 8 7 7 8 7 7 8 7 8 8 7 7 8 7 8 8 7 8 8 8 7 7 8 7 8 7 8 8 8 7 8 7 7 8
8 8 8 8 7 7 7 7 7 7 7 7 7 7 7 7 7 7 8 8 7 7 7 8 7 7 8 8 7 7 7 7 7 8 8 8 7 7 7 7 8 7 8 8 7 8 8 8 7 8
7 7 7 8 8 8 8 7 7 8 8 7 8 8 8 7 8 7 7 8 7 7 7 7 8 7 7 7 8 7 7 7 8 7 8 7 8 7 8 8 8 7 7 7 7 7 7 8 7 7
8 7 7 7 8 7 8 7 8 8 7 8 7 8 7 7 7 8 8 8 7 7 7 7 7 7 8 7 8 7 7 8 8 8 8 7 7 7 8 8 7 7 8 8 8 7 7 7 7 8
7 8 7 7 7 7 7 7 7 7 8 7 7 7 7 8 8 8 7 8 7 8 7 7 8 7 7 8 8 8 7 8 7 8 8 8 8 7 7 8 8 7 7 7 8 8 8 8 7 7
8 7 8 8 8 0 8 0 0 0 0 0 7 0 8 0 0 0 8 0 0 0 0 6 8 0 7 0 7 0 7 0 0 0 0 0 7 0 0 0 7 0 0 0 0 7 7 8 7 7
7 8 7 7 8 6 7 7 7 0 0 6 7 0 0 7 0 0 0 0 0 8 8 0 7 7 7 0 0 0 8 7 0 8 0 0 0 8 0 0 8 8 6 0 0 7 7 8 8 8
8 7 8 7 8 0 0 0 7 0 7 0 8 0 7 0 0 6 0 0 8 0 7 0 0 0 8 0 7 0 0 0 0 0 0 0 0 0 7 0 0 0 0 0 0 7 8 8 7 7
8 7 7 7 7 6 8 0 7 7 6 7 0 0 0 0 0 0 7 7 0 0 7 8 7 0 8 7 0 0 0 0 7 7 7 0 8 0 0 0 0 0 8 8 0 8 7 8 7 7
8 7 7 8 8 0 0 0 0 0 7 0 0 0 0 0 0 0 0 0 0 0 7 0 7 0 8 0 7 0 0 0 7 0 8 0 6 0 8 0 8 0 0 0 7 7 7 8 7 7
7 8 7 7 8 7 8 0 8 8 7 0 0 7 0 0 0 0 0 0 8 0 7 7 7 7 0 8 0 0 0 0 0 7 0 8 8 8 0 0 7 0 0 8 0 8 8 7 7 7
7 7 7 7 8 0 8 0 0 0 0 0 8 0 0 0 7 0 0 0 0 0 0 0 0 0 6 0 7 0 0 0 8 0 7 0 0 0 7 0 7 0 6 0 0 8 7 7 8 7
7 8 8 8 7 0 0 0 7 6 0 0 8 7 8 0 0 0 0 0 7 8 7 7 0 8 0 7 8 0 7 0 0 7 0 0 0 0 7 8 8 8 0 7 7 7 7 8 7 7
7 8 8 7 7 0 7 0 0 0 8 6 7 0 0 0 0 0 8 0 6 0 0 0 0 0 0 0 0 0 0 0 0 0 0 0 6 0 0 0 0 0 0 0 0 8 7 7 8 7
7 7 8 8 8 0 0 0 7 0 0 8 0 7 8 7 0 0 7 6 7 7 6 0 6 0 7 8 7 7 0 0 0 0 0 7 0 7 6 0 0 0 0 0 0 8 7 8 8 7
7 7 8 8 7 0 7 0 6 0 7 0 8 0 8 0 7 0 0 0 0 0 8 0 0 0 8 0 8 0 0 0 0 0 0 0 7 0 8 0 7 0 0 0 8 7 7 8 7 7
7 7 8 7 7 7 0 0 7 0 0 0 8 0 0 0 7 6 7 0 0 6 7 0 0 0 7 0 0 0 7 0 7 0 8 0 7 8 0 6 7 8 0 0 7 8 7 7 7 8
7 7 8 8 7 0 8 0 0 0 7 0 0 0 0 0 0 0 0 6 7 0 6 0 0 0 7 0 0 0 8 6 0 0 8 0 6 0 0 0 0 0 8 0 0 7 8 7 8 7
8 7 7 7 8 0 8 0 8 0 0 7 8 0 7 0 7 8 0 0 0 7 8 0 0 7 7 0 8 0 0 8 7 8 8 6 7 7 0 7 0 0 7 0 0 8 7 8 8 8
8 7 7 7 7 0 8 0 0 0 0 0 0 0 0 0 0 0 7 0 6 0 0 0 0 0 0 0 0 0 0 0 8 0 7 0 0 0 7 0 0 0 0 0 0 8 8 7 7 7
7 7 7 7 8 0 0 0 0 0 0 0 6 0 7 6 0 0 0 8 0 0 0 7 8 7 0 0 7 7 0 7 0 7 0 7 7 0 0 0 0 6 0 0 0 7 7 7 7 7
7 8 7 8 7 0 0 0 0 0 0 0 0 0 8 0 0 0 0 0 7 0 0 0 0 0 0 0 7 0 0 6 8 0 0 0 7 0 0 0 8 0 0 0 0 7 8 7 8 7
8 8 7 8 7 0 8 0 0 0 0 0 0 7 6 0 0 0 0 7 0 8 0 8 7 0 0 0 0 0 7 0 0 0 0 7 0 6 0 0 0 0 0 0 0 7 7 8 8 8
8 8 7 8 8 0 6 0 0 0 0 0 0 0 0 0 0 0 0 0 7 0 0 0 8 6 0 0 7 0 7 0 8 0 0 0 0 0 7 0 6 6 0 0 0 7 8 7 7 7
7 8 8 8 8 0 0 7 0 0 0 0 0 0 0 0 0 7 0 7 8 0 0 0 0 8 6 7 0 0 0 0 0 0 0 7 0 8 8 0 0 0 0 0 7 7 7 8 8 7
7 7 7 7 7 0 0 0 0 0 8 0 0 0 0 0 8 0 0 0 0 0 8 0 7 0 6 0 8 6 7 0 0 0 0 0 8 0 0 0 0 0 7 0 8 8 7 7 8 7
7 8 7 7 8 0 0 0 6 0 0 7 0 0 0 7 0 6 0 0 7 0 7 7 8 0 7 0 0 0 8 7 0 6 7 6 0 8 0 0 0 7 0 7 8 8 8 8 7 7
7 7 8 7 7 6 7 0 8 0 7 0 0 0 0 0 6 0 7 0 8 0 8 0 7 0 0 0 0 0 8 0 0 0 0 0 7 0 0 0 0 0 0 0 0 7 7 7 8 7
8 7 7 7 8 0 7 8 0 0 8 6 0 0 6 0 0 0 7 0 0 0 0 0 0 0 0 0 0 0 0 0 0 0 0 8 0 7 0 7 0 8 0 0 0 7 7 7 8 7
7 8 8 8 7 0 0 0 0 0 0 0 0 0 0 0 0 0 8 0 8 0 0 0 0 0 8 0 7 0 7 0 0 0 0 0 7 0 0 0 8 0 0 0 0 8 7 8 7 8
7 7 7 7 8 0 6 0 7 8 6 8 0 0 7 7 0 8 8 0 7 0 0 0 0 7 7 0 0 8 0 8 0 7 6 0 7 0 7 0 0 8 7 0 8 7 8 8 7 7
8 7 7 8 8 0 0 0 0 0 7 0 7 0 0 0 0 0 0 0 0 0 0 0 0 0 6 0 0 0 0 0 0 0 0 0 0 0 0 0 7 0 0 0 7 8 7 8 8 8
7 7 7 7 7 0 8 6 8 0 7 0 0 0 7 0 0 0 7 0 7 6 0 0 7 0 0 7 7 8 7 0 0 7 0 7 8 0 0 6 0 0 0 0 7 7 7 7 7 7
8 7 8 8 7 0 0 0 8 0 0 6 7 6 0 6 0 0 8 0 0 0 0 0 7 0 0 0 0 0 7 0 8 0 0 6 0 0 0 0 8 6 8 0 0 8 7 7 8 7
8 8 7 8 7 0 0 0 0 8 8 0 0 0 0 0 0 0 0 8 0 0 8 8 0 8 7 7 8 8 7 0 7 0 0 8 7 7 0 6 0 0 7 7 0 8 7 8 8 7
7 8 8 7 7 0 0 0 0 0 0 0 6 0 0 6 8 0 0 0 0 0 0 0 0 0 0 0 6 0 0 0 8 0 8 0 0 6 0 0 7 0 0 0 8 7 7 8 7 7
7 8 7 8 7 0 7 0 7 0 0 0 7 0 7 7 0 7 0 7 0 0 0 8 0 8 7 0 0 0 8 8 7 0 0 0 8 0 7 0 0 0 8 0 0 8 7 7 8 7
8 7 8 7 7 0 6 0 7 0 0 0 0 0 0 0 7 0 7 0 0 0 8 0 0 0 0 0 7 0 7 0 7 0 0 0 0 0 0 0 7 0 0 0 8 8 8 7 8 7
7 8 7 7 7 7 0 0 0 0 0 8 0 7 7 0 0 7 0 0 7 7 0 0 0 0 6 0 6 8 7 7 0 0 0 7 0 0 0 6 0 0 0 7 6 8 8 7 7 8
7 7 8 7 7 0 7 0 0 0 0 0 8 0 8 6 8 0 0 0 0 0 7 0 8 0 0 0 7 0 0 0 8 0 6 0 0 0 0 0 0 0 0 0 7 7 7 7 8 7
7 8 8 8 7 0 7 0 6 0 7 0 0 0 8 7 6 7 0 0 6 0 7 0 7 7 0 8 0 0 0 6 0 8 7 7 0 0 0 7 8 8 0 0 0 8 7 7 8 7
7 7 7 7 7 0 0 0 8 0 0 0 0 0 7 0 8 0 0 0 0 0 0 0 7 0 7 0 0 0 0 0 7 0 7 0 8 0 0 0 0 0 0 0 8 8 8 7 7 7
7 7 7 8 7 0 0 0 0 0 7 7 8 0 0 6 7 7 0 6 0 0 0 7 0 0 0 0 6 8 7 8 0 0 0 0 0 0 0 8 8 7 0 0 8 7 8 7 7 8
8 7 7 7 7 0 7 0 0 0 7 0 0 0 0 0 0 0 8 0 0 0 6 0 7 0 7 0 0 0 8 0 0 0 0 0 0 0 7 0 7 0 0 0 8 7 8 8 7 7
7 8 8 8 7 0 8 8 6 8 0 0 0 0 0 7 0 0 0 8 8 0 0 0 7 6 7 7 0 0 0 0 7 0 8 0 8 0 0 7 0 7 0 0 8 7 7 8 7 7
7 7 8 8 7 8 8 8 7 7 8 7 7 7 8 8 8 8 7 8 7 7 8 7 7 8 7 8 7 7 8 8 7 7 7 8 8 7 7 7 7 8 7 8 8 8 7 7 7 7
7 7 7 8 7 8 8 7 8 7 7 7 8 7 7 7 7 7 7 7 8 8 7 7 8 7 7 8 7 7 8 8 7 8 7 7 8 7 8 8 7 8 7 8 8 7 7 7 7 7
8 8 8 8 8 7 7 7 7 8 7 8 7 7 8 8 7 7 7 8 7 7 7 8 7 7 8 8 7 8 7 8 7 7 8 8 7 7 7 7 7 7 8 7 7 8 7 7 7 7
7 8 7 8 7 8 7 8 7 7 8 7 8 7 8 8 8 7 8 8 7 7 7 8 8 7 7 7 7 8 7 8 7 7 8 8 8 7 8 8 7 8 7 7 7 7 7 7 8 7
7 8 8 7 7 7 8 7 7 7 8 7 8 8 7 7 7 7 8 7 7 7 7 7 8 8 8 8 8 8 7 7 7 7 7 7 7 7 7 8 7 7 7 7 8 7 7 7 8 8
